"aa" = (/turf/open/space/basic,/area/space)
"ab" = (/turf/open/floor/plasteel/dark,/area/space)
"ac" = (/obj/machinery/computer/lore_terminal,/obj/machinery/computer/ship/reactor_control_computer,/turf/open/floor/plasteel/dark,/area/space)
"ad" = (/obj/machinery/atmospherics/components/trinary/filter/atmos/plasma{icon_state = "filter_on"; dir = 4},/obj/structure/cable{icon_state = "4-8"},/obj/machinery/airalarm/directional/north,/turf/open/floor/plasteel/dark,/area/space)
"ae" = (/obj/machinery/atmospherics/components/unary/outlet_injector/on{icon_state = "inje_map-2"; dir = 4},/turf/open/floor/plating,/area/space)
"af" = (/obj/machinery/light/floor,/turf/open/floor/engine,/area/space)
"ag" = (/obj/machinery/particle_accelerator/control_box,/obj/item/stack/cable_coil,/turf/open/floor/plasteel/dark,/area/space)
"ah" = (/obj/structure/particle_accelerator/fuel_chamber,/turf/open/floor/plasteel/dark,/area/space)
"ai" = (/obj/structure/particle_accelerator/end_cap,/obj/machinery/light{dir = 1},/turf/open/floor/plasteel/dark,/area/space)
"aj" = (/obj/structure/particle_accelerator/power_box,/turf/open/floor/plasteel/dark,/area/space)
"ak" = (/obj/item/stack/cable_coil,/turf/open/floor/plasteel/dark,/area/space)
"al" = (/obj/structure/particle_accelerator/particle_emitter/left,/turf/open/floor/plasteel/dark,/area/space)
"am" = (/obj/structure/particle_accelerator/particle_emitter/center,/turf/open/floor/plasteel/dark,/area/space)
"an" = (/obj/structure/particle_accelerator/particle_emitter/right,/turf/open/floor/plasteel/dark,/area/space)
"ao" = (/turf/open/floor/engine,/area/space)
"ap" = (/obj/structure/window/plasma/fulltile,/obj/structure/grille,/obj/machinery/door/firedoor/heavy,/turf/open/floor/plating,/area/space)
"aq" = (/obj/machinery/atmospherics/pipe/simple/orange/visible{dir = 4},/obj/structure/cable{icon_state = "4-8"},/turf/open/floor/plasteel/dark,/area/space)
"ar" = (/obj/effect/landmark/event_spawn,/obj/machinery/airalarm/directional/south,/turf/open/floor/plasteel/dark,/area/space)
"as" = (/obj/effect/landmark/nuclear_waste_spawner/strong,/turf/open/floor/engine,/area/space)
"at" = (/turf/closed/wall/ship,/area/space)
"au" = (/obj/machinery/atmospherics/pipe/simple/scrubbers/visible{dir = 4},/obj/machinery/door/airlock/ship/public/glass{name = "Stormdrive Reactor Core"; req_one_access_txt = "11; 24"},/obj/effect/mapping_helpers/airlock/cyclelink_helper{dir = 4},/turf/open/floor/plasteel/dark,/area/space)
"av" = (/obj/machinery/atmospherics/components/unary/vent_pump/high_volume{dir = 8},/obj/machinery/power/supermatter_crystal/shard/engine,/turf/open/floor/engine,/area/space)
"aw" = (/obj/machinery/atmospherics/components/unary/vent_scrubber{icon_state = "scrub_map-2"; dir = 4},/turf/open/floor/engine,/area/space)
"ax" = (/obj/machinery/atmospherics/pipe/simple/orange/visible{dir = 4},/obj/structure/window/plasma/fulltile,/obj/structure/grille,/obj/machinery/door/firedoor/heavy,/turf/open/floor/plating,/area/space)
"ay" = (/obj/machinery/atmospherics/pipe/simple/orange/visible{dir = 4},/obj/structure/cable{icon_state = "0-4"},/obj/machinery/power/emitter/anchored{anchored = 2; dir = 8; icon_state = "emitter"},/obj/machinery/door/firedoor/heavy,/obj/structure/window/plasma/reinforced{icon_state = "plasmarwindow"; dir = 8},/turf/open/floor/plasteel/dark,/area/space)
"az" = (/obj/machinery/atmospherics/pipe/simple/orange/visible{dir = 6},/obj/structure/lattice,/turf/open/space/basic,/area/space)
"aA" = (/obj/machinery/atmospherics/pipe/heat_exchanging/junction,/obj/structure/lattice,/turf/open/space/basic,/area/space)
"aB" = (/obj/machinery/atmospherics/pipe/heat_exchanging/simple{icon_state = "pipe11-2"; dir = 1},/obj/structure/lattice,/turf/open/space/basic,/area/space)
"aC" = (/obj/machinery/atmospherics/pipe/heat_exchanging/simple{icon_state = "pipe11-2"; dir = 6},/obj/structure/lattice,/turf/open/space/basic,/area/space)
"aD" = (/obj/machinery/atmospherics/pipe/heat_exchanging/simple{icon_state = "pipe11-2"; dir = 10},/obj/structure/lattice,/turf/open/space/basic,/area/space)
"aE" = (/obj/machinery/atmospherics/pipe/heat_exchanging/simple,/obj/structure/lattice,/turf/open/space/basic,/area/space)
"aF" = (/obj/machinery/atmospherics/pipe/heat_exchanging/simple{icon_state = "pipe11-2"; dir = 5},/obj/structure/lattice,/turf/open/space/basic,/area/space)
"aG" = (/obj/machinery/atmospherics/pipe/heat_exchanging/simple{icon_state = "pipe11-2"; dir = 9},/obj/structure/lattice,/turf/open/space/basic,/area/space)
"aH" = (/obj/machinery/atmospherics/components/unary/outlet_injector/atmos/toxin_input{icon_state = "inje_map-2"; dir = 1},/obj/machinery/door/firedoor/heavy,/obj/structure/window/plasma/reinforced{icon_state = "plasmarwindow"; dir = 1},/obj/structure/window/plasma/reinforced{icon_state = "plasmarwindow"; dir = 8},/turf/open/floor/engine/plasma,/area/space)
"aI" = (/obj/machinery/atmospherics/components/unary/vent_scrubber,/turf/open/floor/engine,/area/space)
"aJ" = (/obj/machinery/atmospherics/components/unary/vent_pump/siphon/atmos/toxin_output{icon_state = "vent_map_siphon_on-2"; dir = 4},/obj/machinery/door/firedoor/heavy,/obj/structure/window/plasma/reinforced{icon_state = "plasmarwindow"; dir = 1},/obj/structure/window/plasma/reinforced{icon_state = "plasmarwindow"; dir = 4},/turf/open/floor/engine/plasma,/area/space)
"aK" = (/obj/machinery/atmospherics/pipe/simple/orange/visible{dir = 5},/obj/structure/window/plasma/fulltile,/obj/structure/grille,/obj/machinery/door/firedoor/heavy,/turf/open/floor/plating,/area/space)
"aL" = (/obj/machinery/atmospherics/components/trinary/filter/atmos/o2{icon_state = "filter_on"; dir = 4},/obj/structure/cable{icon_state = "4-8"},/turf/open/floor/plasteel/dark,/area/space)
"aM" = (/obj/machinery/atmospherics/pipe/simple/purple/visible{dir = 4},/turf/open/floor/plasteel/dark,/area/space)
"aN" = (/obj/machinery/atmospherics/pipe/simple/scrubbers/visible{dir = 4},/obj/machinery/atmospherics/pipe/simple/orange/visible/layer1{icon_state = "pipe11-1"; dir = 8},/turf/open/floor/engine,/area/space)
"aO" = (/obj/machinery/atmospherics/pipe/simple/purple/visible{dir = 4},/obj/machinery/atmospherics/pipe/simple/cyan/visible,/turf/open/floor/plasteel/dark,/area/space)
"aP" = (/obj/machinery/atmospherics/pipe/simple/purple/visible{dir = 10},/obj/machinery/atmospherics/pipe/simple/orange/visible/layer1,/obj/structure/cable{icon_state = "1-2"},/obj/structure/cable{icon_state = "2-4"},/turf/open/floor/plasteel/dark,/area/space)
"aQ" = (/obj/machinery/atmospherics/pipe/simple/cyan/visible{dir = 5},/turf/open/floor/plasteel/dark,/area/space)
"aR" = (/obj/machinery/atmospherics/pipe/simple/cyan/visible{dir = 10},/turf/open/floor/plasteel/dark,/area/space)
"aS" = (/obj/machinery/power/stormdrive_reactor,/obj/effect/landmark/event_spawn,/obj/machinery/atmospherics/components/binary/pump/reactor_manifold{dir = 8},/obj/structure/cable/yellow{icon_state = "0-4"},/obj/machinery/atmospherics/pipe/simple/orange/visible/layer1{icon_state = "pipe11-1"; dir = 8},/turf/open/floor/engine,/area/space)
"aT" = (/obj/machinery/atmospherics/pipe/simple/purple/visible{dir = 8},/obj/structure/cable/yellow{icon_state = "4-8"},/obj/machinery/atmospherics/pipe/simple/orange/visible/layer1{icon_state = "pipe11-1"; dir = 8},/turf/open/floor/engine,/area/space)
"aU" = (/obj/machinery/atmospherics/pipe/simple/purple/visible,/obj/machinery/atmospherics/pipe/simple/orange/visible/layer1,/obj/structure/cable{icon_state = "1-2"},/turf/open/floor/plasteel/dark,/area/space)
"aV" = (/obj/machinery/atmospherics/pipe/manifold/cyan/visible{icon_state = "manifold-2"; dir = 4},/turf/open/floor/plasteel/dark,/area/space)
"aW" = (/obj/machinery/atmospherics/pipe/simple/cyan/visible{icon_state = "pipe11-2"; dir = 9},/obj/machinery/computer/ship/ftl_computer{icon_state = "ftl_off"; dir = 1},/turf/open/floor/plasteel/dark,/area/space)
"aX" = (/obj/machinery/atmospherics/pipe/simple/cyan/visible{dir = 4},/obj/machinery/computer/atmos_control/tank/oxygen_tank{icon_state = "computer"; dir = 4},/turf/open/floor/plasteel/dark,/area/space)
"aY" = (/obj/machinery/atmospherics/pipe/simple/purple/visible,/obj/machinery/atmospherics/pipe/simple/orange/visible/layer1,/obj/machinery/atmospherics/components/binary/pump/on{dir = 4; name = "O2 Output"},/obj/structure/cable{icon_state = "1-2"},/turf/open/floor/plasteel/dark,/area/space)
"aZ" = (/obj/machinery/atmospherics/pipe/layer_manifold/visible{dir = 4},/obj/structure/cable{icon_state = "4-8"},/turf/open/floor/plasteel/dark,/area/space)
"ba" = (/obj/structure/window/plasma/fulltile,/obj/structure/grille,/obj/machinery/atmospherics/pipe/manifold4w/orange/visible,/obj/machinery/door/firedoor/heavy,/turf/open/floor/plating,/area/space)
"bb" = (/obj/machinery/atmospherics/components/unary/outlet_injector/atmos/oxygen_input{icon_state = "inje_map-2"; dir = 4},/obj/machinery/door/firedoor/heavy,/obj/structure/window/plasma/reinforced{icon_state = "plasmarwindow"; dir = 1},/obj/structure/window/plasma/reinforced{icon_state = "plasmarwindow"; dir = 8},/obj/structure/window/plasma/reinforced{icon_state = "plasmarwindow"; dir = 4},/turf/open/floor/engine/o2,/area/space)
"bc" = (/obj/machinery/atmospherics/pipe/simple/purple/visible{dir = 10},/obj/structure/cable{icon_state = "4-8"},/turf/open/floor/plasteel/dark,/area/space)
"bd" = (/obj/machinery/atmospherics/pipe/simple/orange/visible/layer1,/obj/machinery/atmospherics/components/binary/magnetic_constrictor,/turf/open/floor/plasteel/dark,/area/space)
"be" = (/obj/machinery/atmospherics/components/binary/magnetic_constrictor,/turf/open/floor/plasteel/dark,/area/space)
"bf" = (/obj/machinery/atmospherics/components/unary/thermomachine/heater/on{dir = 4},/turf/open/floor/plating,/area/space)
"bg" = (/obj/machinery/atmospherics/pipe/simple/scrubbers/visible{dir = 4},/turf/open/floor/plasteel/dark,/area/space)
"bh" = (/obj/effect/spawner/structure/window/reinforced/ship,/obj/machinery/door/firedoor/heavy,/turf/open/floor/plating,/area/space)
"bi" = (/obj/machinery/atmospherics/pipe/simple/orange/visible/layer1{icon_state = "pipe11-1"; dir = 8},/obj/machinery/atmospherics/components/binary/pump/on{dir = 8},/obj/structure/cable/yellow{icon_state = "4-8"},/turf/open/floor/plasteel/dark,/area/space)
"bj" = (/obj/structure/cable{icon_state = "2-8"},/obj/structure/reagent_dispensers/foamtank,/turf/open/floor/plasteel/dark,/area/space)
"bk" = (/obj/machinery/atmospherics/pipe/simple/purple/visible{dir = 9},/obj/structure/cable/yellow{icon_state = "4-8"},/obj/structure/reagent_dispensers/fueltank,/turf/open/floor/plasteel/dark,/area/space)
"bl" = (/obj/machinery/atmospherics/pipe/simple/orange/visible/layer1{icon_state = "pipe11-1"; dir = 10},/obj/structure/cable{icon_state = "2-8"},/turf/open/floor/plasteel/dark,/area/space)
"bm" = (/obj/machinery/atmospherics/components/unary/vent_pump/siphon/atmos/oxygen_output{icon_state = "vent_map_siphon_on-2"; dir = 4},/obj/machinery/door/firedoor/heavy,/obj/structure/window/plasma/reinforced{icon_state = "plasmarwindow"; dir = 8},/obj/structure/window/plasma/reinforced{icon_state = "plasmarwindow"; dir = 4},/turf/open/floor/engine/o2,/area/space)
"bn" = (/obj/machinery/atmospherics/pipe/simple/orange/visible/layer1,/obj/machinery/atmospherics/pipe/manifold/purple/visible{icon_state = "manifold-2"; dir = 8},/obj/structure/cable{icon_state = "1-4"},/turf/open/floor/plasteel/dark,/area/space)
"bo" = (/obj/machinery/power/terminal{dir = 1},/obj/structure/cable/yellow{icon_state = "0-8"},/obj/structure/reagent_dispensers/fueltank,/turf/open/floor/plasteel/dark,/area/space)
"bp" = (/obj/machinery/atmospherics/pipe/simple/orange/visible/layer1{icon_state = "pipe11-1"; dir = 9},/obj/machinery/atmospherics/pipe/manifold/purple/visible,/obj/structure/cable/yellow{icon_state = "4-8"},/obj/machinery/airalarm/directional/south,/turf/open/floor/plasteel/dark,/area/space)
"bq" = (/obj/machinery/power/smes/engineering,/obj/structure/cable,/turf/open/floor/plasteel/dark,/area/space)
"br" = (/obj/effect/spawner/structure/window/reinforced/ship,/turf/open/floor/plating,/area/space)
"bs" = (/obj/structure/lattice,/turf/open/space/basic,/area/space)
"bt" = (/obj/structure/lattice/catwalk,/turf/open/space/basic,/area/space)
"bu" = (/obj/machinery/atmospherics/components/unary/portables_connector/visible{dir = 8},/turf/open/floor/plasteel/dark,/area/space)
"bv" = (/obj/machinery/atmospherics/components/binary/pump/on{dir = 8; name = "Supermatter Loop Injector"},/turf/closed/wall/ship,/area/space)
"bw" = (/obj/machinery/atmospherics/pipe/layer_manifold/visible{dir = 4},/obj/machinery/door/airlock/ship/public/glass{name = "Stormdrive Reactor Core"; req_one_access_txt = "11; 24"},/obj/machinery/door/firedoor/heavy,/obj/effect/mapping_helpers/airlock/cyclelink_helper{dir = 8},/turf/open/floor/plasteel/dark,/area/space)
"bx" = (/obj/machinery/atmospherics/pipe/simple/purple/visible,/obj/machinery/atmospherics/pipe/simple/orange/visible/layer1,/obj/structure/cable{icon_state = "1-2"},/obj/machinery/door/airlock/ship/public/glass{name = "Stormdrive Plasma Constriction"; req_one_access_txt = "10"},/turf/open/floor/plasteel/dark,/area/space)
"by" = (/obj/machinery/atmospherics/pipe/simple/purple/visible{dir = 8},/obj/machinery/atmospherics/pipe/simple/orange/visible/layer1{icon_state = "pipe11-1"; dir = 8},/obj/structure/cable/yellow{icon_state = "4-8"},/obj/machinery/door/airlock/ship/public/glass{name = "Stormdrive Reactor Core"; req_one_access_txt = "11; 24"},/obj/machinery/door/firedoor/heavy,/turf/open/floor/plasteel/dark,/area/space)
"bz" = (/obj/structure/closet/secure_closet/engineering_chief,/obj/structure/window/plasma/reinforced,/obj/machinery/door/window/westright{name = "Chief Engineer's Storage"; req_one_access_txt = "56"},/obj/machinery/suit_storage_unit/ce,/obj/machinery/keycard_auth{pixel_y = 32},/obj/machinery/requests_console{announcementConsole = 1; department = "Chief Engineer's Desk"; departmentType = 4; name = "Chief Engineer RC"; pixel_x = 32; pixel_y = 1},/turf/open/floor/plasteel/dark,/area/space)
"bA" = (/obj/structure/closet/secure_closet/atmospherics,/obj/structure/window/plasma/reinforced{icon_state = "plasmarwindow"; dir = 1},/obj/machinery/door/window/westright{name = "Atmospheric Technician's Storage"; req_one_access_txt = "24"},/obj/machinery/suit_storage_unit/atmos,/obj/machinery/requests_console{department = "Atmospherics"; departmentType = 3; name = "Atmos RC"; pixel_x = 32},/turf/open/floor/plasteel/dark,/area/space)
"bB" = (/obj/structure/closet/secure_closet/engineering_electrical,/obj/structure/window/plasma/reinforced{icon_state = "plasmarwindow"; dir = 1},/obj/machinery/door/window/westright{name = "Chief Engineer's Storage"; req_one_access_txt = "56"},/obj/machinery/suit_storage_unit/engine,/turf/open/floor/plasteel/dark,/area/space)
"bC" = (/obj/structure/closet/secure_closet/engineering_welding,/obj/structure/window/plasma/reinforced{icon_state = "plasmarwindow"; dir = 1},/obj/machinery/door/window/westright{name = "Engineering Equipment"; req_one_access_txt = "10"},/obj/machinery/suit_storage_unit/engine,/turf/open/floor/plasteel/dark,/area/space)
"bD" = (/obj/machinery/atmospherics/pipe/simple/purple/visible{dir = 4},/obj/machinery/computer/atmos_control/tank/toxin_tank{icon_state = "computer"; dir = 4},/turf/open/floor/plasteel/dark,/area/space)
"bE" = (/obj/structure/closet/radiation,/obj/structure/window/plasma/reinforced{icon_state = "plasmarwindow"; dir = 1},/obj/machinery/door/window/westright{name = "Engineering Equipment"; req_one_access_txt = "10"},/obj/machinery/suit_storage_unit/engine,/turf/open/floor/plasteel/dark,/area/space)
"bF" = (/obj/structure/cable{icon_state = "4-8"},/turf/open/floor/plasteel/dark,/area/space)
"bG" = (/obj/machinery/door/airlock/ship/public/glass{name = "Engineering"; req_one_access_txt = "10; 24"},/obj/structure/cable{icon_state = "4-8"},/turf/open/floor/plating,/area/space)
"bH" = (/obj/machinery/airalarm/directional/south,/turf/open/floor/plasteel/dark,/area/space)
"bI" = (/obj/machinery/atmospherics/pipe/simple/orange/visible{dir = 4},/obj/structure/cable{icon_state = "4-8"},/obj/machinery/firealarm/directional/north,/turf/open/floor/plasteel/dark,/area/space)
"bJ" = (/obj/machinery/firealarm/directional/west,/turf/open/floor/plasteel/dark,/area/space)
"bK" = (/obj/machinery/firealarm/directional/north,/turf/open/floor/plasteel/dark,/area/space)
"bL" = (/obj/machinery/newscaster/directional/west,/turf/open/floor/plasteel/dark,/area/space)
"bM" = (/obj/machinery/atmospherics/pipe/simple/purple/visible,/obj/machinery/atmospherics/pipe/simple/orange/visible/layer1,/obj/structure/cable{icon_state = "1-2"},/obj/structure/chair/office,/turf/open/floor/plasteel/dark,/area/space)
"bN" = (/obj/structure/chair/office,/turf/open/floor/plasteel/dark,/area/space)

(1,1,1) = {"
aaaaaaaaaaaaaaaaaaaaaaaaaaaaaaaaaaaaaaaaaaaaaaaaaaaaaaaaaaaaaaaaaaaaaaaaaaaaaaaaaaaaaaaaaaaaaaaaaaaaaa
aaaaaaaaaaaaaaaaaaaaaaaaaaaaaaaaaaaaaaaaaaaaaaaaaaaaaaaaaaaaaaaaaaaaaaaaaaaaaaaaaaaaaaaaaaaaaaaaaaaaaa
aaaaaaaaaaaaaaaaaaaaaaaaaaaaaaaaaaaaaaaaaaaaaaaaaaaaaaaaaaaaaaaaaaaaaaaaaaaaaaaaaaaaaaaaaaaaaaaaaaaaaa
aaaaaaaaaaaaaaaaaaaaaaaaaaaaaaaaaaaaaaaaaaaaaaaaaaaaaaaaaaaaaaaaaaaaaaaaaaaaaaaaaaaaaaaaaaaaaaaaaaaaaa
aaaaaaaaaaaaaaaaaaaaaaaaaaaaaaaaaaaaaaaaaaaaaaaaaaaaaaaaaaaaaaaaaaaaaaaaaaaaaaaaaaaaaaaaaaaaaaaaaaaaaa
aaaaaaaaaaaaaaaaaaaaaaaaaaaaaaaaaaaaaaaaaaaaaaaaaaaaaaaaaaaaaaaaaaaaaaaaaaaaaaaaaaaaaaaaaaaaaaaaaaaaaa
aaaaaaaaaaaaaaaaaaaaaaaaaaaaaaaaaaaaaaaaaaaaaaaaaaaaaaaaaaaaaaaaaaaaaaaaaaaaaaaaaaaaaaaaaaaaaaaaaaaaaa
aaaaaaaaaaaaaaaaaaaaaaaaaaaaaaaaaaaaaaaaaaaaaaaaaaaaaaaaaaaaaaaaaaaaaaaaaaaaaaaaaaaaaaaaaaaaaaaaaaaaaa
aaaaaaaaaaaaaaaaaaaaaaaaaaaaaaaaaaaaaaaaaaaaaaaaaaaaaaaaaaaaaaaaaaaaaaaaaaaaaaaaaaaaaaaaaaaaaaaaaaaaaa
aaaaaaaaaaaaaaaaaaaaaaaaaaaaaaaaaaaaaaaaaaaaaaaaaaaaaaaaaaaaaaaaaaaaaaaaaaaaaaaaaaaaaaaaaaaaaaaaaaaaaa
aaaaaaaaaaaaaaaaaaaaaaaaaaaaaaaaaaaaaaaaaaaaaaaaaaaaaaaaaaaaaaaaaaaaaaaaaaaaaaaaaaaaaaaaaaaaaaaaaaaaaa
aaaaaaaaaaaaaaaaaaaaaaaaaaaaaaaaaaaaaaaaaaaaaaaaaaaaaaaaaaaaaaaaaaaaaaaaaaaaaaaaaaaaaaaaaaaaaaaaaaaaaa
aaaaaaaaaaaaaaaaaaaaaaaaaaaaaaaaaaaaaaaaaaaaaaaaaaaaaaaaaaaaaaaaaaaaaaaaaaaaaaaaaaaaaaaaaaaaaaaaaaaaaa
aaaaaaaaaaaaaaaaaaaaaaaaaaaaaaaaaaaaaaaaaaaaaaaaaaaaaaaaaaaaaaaaaaaaaaaaaaaaaaaaaaaaaaaaaaaaaaaaaaaaaa
aaaaaaaaaaaaaaaaaaaaaaaaaaaaaaaaaaaaaaaaaaaaaaaaaaaaaaaaaaaaaaaaaaaaaaaaaaaaaaaaaaaaaaaaaaaaaaaaaaaaaa
aaaaaaaaaaaaaaaaaaaaaaaaaaaaaaaaaaaaaaaaaaaaaaaaaaaaaaaaaaaaaaaaaaaaaaaaaaaaaaaaaaaaaaaaaaaaaaaaaaaaaa
aaaaaaaaaaaaaaaaaaaaaaaaaaaaaaaaaaaaaaaaaaaaaaaaaaaaaaaaaaaaaaaaaaaaaaaaaaaaaaaaaaaaaaaaaaaaaaaaaaaaaa
aaaaaaaaaaaaaaaaaaaaaaaaaaaaaaaaaaaaaaaaaaaaaaaaaaaaaaaaaaaaaaaaaaaaaaaaaaaaaaaaaaaaaaaaaaaaaaaaaaaaaa
aaaaaaaaaaaaaaaaaaaaaaaaaaaaaaaaaaaaaaaaaaaaaaaaaaaaaaaaaaaaaaaaaaaaaaaaaaaaaaaaaaaaaaaaaaaaaaaaaaaaaa
aaaaaaaaaaaaaaaaaaaaaaaaaaaaaaaaaaaaaaaaaaaaaaaaaaaaaaaaaaaaaaaaaaaaaaaaaaaaaaaaaaaaaaaaaaaaaaaaaaaaaa
aaaaaaaaaaaaaaaaaaaaaaaaaaaaaaaaaaaaaaaaaaaaaaaaaaaaaaaaaaaaaaaaaaaaaaaaaaaaaaaaaaaaaaaaaaaaaaaaaaaaaa
aaaaaaaaatapapatatatatatatatatatatataaaaaaaaaaaaaaaaaaaaaaaaaaaaaaaaaaaaaaaaaaaaaaaaaaaaaaaaaaaaaaaaaa
aaaaaaazaxavawaybIadaqaqaLaZblbKbzataaaaaaaaaaaaaaaaaaaaaaaaaaaaaaaaaaaaaaaaaaaaaaaaaaaaaaaaaaaaaaaaaa
aaaaaaaAapaIaIatabaHaJbDaOaMaPbFbFbGaaaaaaaaaaaaaaaaaaaaaaaaaaaaaaaaaaaaaaaaaaaaaaaaaaaaaaaaaaaaaaaaaa
aaaaaaaBataKbabvbuatatbJaQaRaUabbAataaaaaaaaaaaaaaaaaaaaaaaaaaaaaaaaaaaaaaaaaaaaaaaaaaaaaaaaaaaaaaaaaa
aaaaaaaBaCaDaAatbLacaiabbfaVbMabbBataaaaaaaaaaaaaaaaaaaaaaaaaaaaaaaaaaaaaaaaaaaaaaaaaaaaaaaaaaaaaaaaaa
aaaaaaaBaBaBaEatbNagahabbbaWaUabbCataaaaaaaaaaaaaaaaaaaaaaaaaaaaaaaaaaaaaaaaaaaaaaaaaaaaaaaaaaaaaaaaaa
aaaaaaaBaBaBaEatarabajakbmaXaYbHbEataaaaaaaaaaaaaaaaaaaaaaaaaaaaaaaaaaaaaaaaaaaaaaaaaaaaaaaaaaaaaaaaaa
aaaaaaaBaBaBaBatatalamanatatbxatatataaaaaaaaaaaaaaaaaaaaaaaaaaaaaaaaaaaaaaaaaaaaaaaaaaaaaaaaaaaaaaaaaa
aaaaaaaFaGaFaGbsatbhbhbhatbJbnbcbjataaaaaaaaaaaaaaaaaaaaaaaaaaaaaaaaaaaaaaaaaaaaaaaaaaaaaaaaaaaaaaaaaa
aaaaaabsbtbtatatatafaoafatabbdbebqataaaaaaaaaaaaaaaaaaaaaaaaaaaaaaaaaaaaaaaaaaaaaaaaaaaaaaaaaaaaaaaaaa
aaaaaabsbtaeaubgbwaNaSaTbybibpbkboataaaaaaaaaaaaaaaaaaaaaaaaaaaaaaaaaaaaaaaaaaaaaaaaaaaaaaaaaaaaaaaaaa
aaaaaabsbtbtatatatafasafatatatatatataaaaaaaaaaaaaaaaaaaaaaaaaaaaaaaaaaaaaaaaaaaaaaaaaaaaaaaaaaaaaaaaaa
aaaaaabsbsbsbsbsatbrbrbrataaaaaaaaaaaaaaaaaaaaaaaaaaaaaaaaaaaaaaaaaaaaaaaaaaaaaaaaaaaaaaaaaaaaaaaaaaaa
aaaaaaaaaaaaaaaaaaaaaaaaaaaaaaaaaaaaaaaaaaaaaaaaaaaaaaaaaaaaaaaaaaaaaaaaaaaaaaaaaaaaaaaaaaaaaaaaaaaaaa
aaaaaaaaaaaaaaaaaaaaaaaaaaaaaaaaaaaaaaaaaaaaaaaaaaaaaaaaaaaaaaaaaaaaaaaaaaaaaaaaaaaaaaaaaaaaaaaaaaaaaa
aaaaaaaaaaaaaaaaaaaaaaaaaaaaaaaaaaaaaaaaaaaaaaaaaaaaaaaaaaaaaaaaaaaaaaaaaaaaaaaaaaaaaaaaaaaaaaaaaaaaaa
aaaaaaaaaaaaaaaaaaaaaaaaaaaaaaaaaaaaaaaaaaaaaaaaaaaaaaaaaaaaaaaaaaaaaaaaaaaaaaaaaaaaaaaaaaaaaaaaaaaaaa
aaaaaaaaaaaaaaaaaaaaaaaaaaaaaaaaaaaaaaaaaaaaaaaaaaaaaaaaaaaaaaaaaaaaaaaaaaaaaaaaaaaaaaaaaaaaaaaaaaaaaa
aaaaaaaaaaaaaaaaaaaaaaaaaaaaaaaaaaaaaaaaaaaaaaaaaaaaaaaaaaaaaaaaaaaaaaaaaaaaaaaaaaaaaaaaaaaaaaaaaaaaaa
aaaaaaaaaaaaaaaaaaaaaaaaaaaaaaaaaaaaaaaaaaaaaaaaaaaaaaaaaaaaaaaaaaaaaaaaaaaaaaaaaaaaaaaaaaaaaaaaaaaaaa
aaaaaaaaaaaaaaaaaaaaaaaaaaaaaaaaaaaaaaaaaaaaaaaaaaaaaaaaaaaaaaaaaaaaaaaaaaaaaaaaaaaaaaaaaaaaaaaaaaaaaa
aaaaaaaaaaaaaaaaaaaaaaaaaaaaaaaaaaaaaaaaaaaaaaaaaaaaaaaaaaaaaaaaaaaaaaaaaaaaaaaaaaaaaaaaaaaaaaaaaaaaaa
aaaaaaaaaaaaaaaaaaaaaaaaaaaaaaaaaaaaaaaaaaaaaaaaaaaaaaaaaaaaaaaaaaaaaaaaaaaaaaaaaaaaaaaaaaaaaaaaaaaaaa
aaaaaaaaaaaaaaaaaaaaaaaaaaaaaaaaaaaaaaaaaaaaaaaaaaaaaaaaaaaaaaaaaaaaaaaaaaaaaaaaaaaaaaaaaaaaaaaaaaaaaa
aaaaaaaaaaaaaaaaaaaaaaaaaaaaaaaaaaaaaaaaaaaaaaaaaaaaaaaaaaaaaaaaaaaaaaaaaaaaaaaaaaaaaaaaaaaaaaaaaaaaaa
aaaaaaaaaaaaaaaaaaaaaaaaaaaaaaaaaaaaaaaaaaaaaaaaaaaaaaaaaaaaaaaaaaaaaaaaaaaaaaaaaaaaaaaaaaaaaaaaaaaaaa
aaaaaaaaaaaaaaaaaaaaaaaaaaaaaaaaaaaaaaaaaaaaaaaaaaaaaaaaaaaaaaaaaaaaaaaaaaaaaaaaaaaaaaaaaaaaaaaaaaaaaa
aaaaaaaaaaaaaaaaaaaaaaaaaaaaaaaaaaaaaaaaaaaaaaaaaaaaaaaaaaaaaaaaaaaaaaaaaaaaaaaaaaaaaaaaaaaaaaaaaaaaaa
aaaaaaaaaaaaaaaaaaaaaaaaaaaaaaaaaaaaaaaaaaaaaaaaaaaaaaaaaaaaaaaaaaaaaaaaaaaaaaaaaaaaaaaaaaaaaaaaaaaaaa
aaaaaaaaaaaaaaaaaaaaaaaaaaaaaaaaaaaaaaaaaaaaaaaaaaaaaaaaaaaaaaaaaaaaaaaaaaaaaaaaaaaaaaaaaaaaaaaaaaaaaa
"}
